*************
***u**********
***u**********
***uu**********
****uu********
*****uu*******
*************
*************
*************
*************